NO ./textures/north.xpm
SO ./textures/south.xpm
WE ./textures/west.xpm
EA ./textures/east.xpm
F 220,100,0
C 225,30,0


        1111111111111111111111111
        10C0000000110000000000001
        1011000001110000000000001
        1001000000000000000000001
111111111011000001110000000000001
100C00000011000001110111100011111
11110111111111011100000010001
11110111111111011101010010001
11000B00110101011100000010B01
10000000000000001100000010001
10000000000000001101010010001
11000001110101011111011110N0111
1111B111 111C101   101111010001
11111111 1111111   111111111111