NO ./textures/north.xpm
SO ./textures/south.xpm
WE ./textures/west.xpm
EA ./textures/east.xpm
F 163,212,185
C 181,208,230

111111
1C0001
1010B1
1000N1
111111