NO ./textures/north.xpm
SO ./textures/south.xpm
WE ./textures/west.xpm
EA ./textures/east.xpm
F 163,212,185
C 181,208,230

111111111111111111111111111111111111
1C000000000000000000000000000000000C1
 1111100000B0000000000111100000000001
1C00000011110000000000000000001110001
10000000000000011110000B000000B111111
11111100B00000C00000000000000000000C1
1C000000000011111111111000B1111111111
1111000B000000C11111100000000110000C1
1C000000000000000000000B1111111000001
1B0000000000000000000000000000B0000N1
1111111111111111111111111111111111111