NO ./textures/north.xpm
SO ./textures/south.xpm
WE ./textures/west.xpm
EA ./textures/east.xpm
F 163,1,185
C 181,f,200

111111
100011
1010N1
100001
111111