NO ./textures/north.xpm
SO ./textures/south.xpm
WE ./textures/west.xpm
EA ./textures/ugheufeqeast.xpm
F 163,212,185
C 181,208,230

111111
100001
1010N1
100001
111111