NO ./textures/north.xpm
SO ./textures/south.xpm
WE ./textures/west.xpm
EA ./textures/east.xpm
F 163,212,185
C 181,208,230


11111
1N0B1
11111
111C1
11111