NO ./textures/north.xpm
SO ./textures/south.xpm
WE ./textures/west.xpm
EA ./textures/east.xpm
F 163,212,185
C 181,208,230

111111
100001
101N01
100001
111111
gusfgfiywgf